22 15
 **************
              *
************* *
*   *         *
* *  *  *******
*  *  *       *
**  *  ****** *
* *  *  *     *
* **  *  *  ***
*   *  *  *   *
* *  *  *  ** *
*  *  *  *  * *
**  *  *  *   *
***  *  *  ****
*  *  *  *  ***
*   *  *  *  **
* *  *  *  *  *
*  *  *  *    *
**  *    ******
***  **********
***           *
*************  
