10 10
  ********
         *
******** *
*        *
* ********
*        *
****** ***
**     ***
*****   **
******      